-------------------------
-                       -
-                       -
-                       -
-            --         -
-                       -
--                      -
-                       -
-                   --- -
-                       -
-                       -
-      ---              -
-                       -
-   -----------        -
-                       -
-                -      -
-                   --  -
-                       -
-                       -
-------------------------